$ANSIBLE_VAULT;1.1;AES256
37356631643564386631363732343866303331636538653238643863656161653264343933663935
3536373038373935363365313364373966306237653531320a366164356538303132373133353235
32356232613639623234323038326139663162646532393038646637366263383331643465643564
6263646530613566300a663635623364313533373665663163646236313662316563623164643633
38363030356161376463373836303432653565386333313462383263613537396462623333613066
36333464646630393464333430393233616562333332383965353130393437333365633232616431
61306230633661333537393865326535383764383261643733333536373765643131323730386437
39626665656462613961643261663630646238396466326363383765303337633730346164643462
35666363333264653062663231623039333435306430396235616465363064663763373832313533
36643738363061393233626136393261383565363966633033336331636432623864323364613463
65393239356431386137336234623439623165323066633262616231333565656634373437636464
61326336306133313662363033643132653365616264363061366463393535613837353337343165
61313938616466336637633330663439366461306237346136396631636164626363646637613330
35656331343737303061353731623333623863666537393339653039663634653661373339313939
39306265313264363139356531373236306566313062623665393239373738626461303433653134
37323365633565303530396434326466316461653838646335366465313262323332656365303233
61363738623865396330376238386639656138313836303937333935343464383364653662333939
64313233643061306566383333616666303062626135303335653531623264366638383236636138
30386335613033633137636236656366363366383539333739303765643134646336396137643463
61666133343234623430383138366334383033633761316665663134386637316136663135666139
36303437623938643339626664383761646334306432336661633136613930356365346136616339
39623533623266626166306635653836633533363563306164626562386535343534363161653831
62646461663331373934356364653832636364366262376236373464313930303265636661393163
30646130653333646339313265626361393832643264393066393730616163623765356430376435
61303863643132333237386632616233353836663638646230656531316565373932643532613039
33336132633766323461336132653634663361666332336566323833326133373635303030343864
64363230663533373135373132346339626265313339326238633633373737356338323337313135
35326265303865386635343635343736393834363031656535363333383066393263633864393137
30633032656230623664316531396537343366343531356132623532353662356561663036343338
62373737313633336161346562656339643034396336306538303230396231666566316631303464
38613537333034386238646330346365326338373439633333316463663231626532656566626338
32323863613463323435343435303538393366623330376136323535393463623730316665333732
64366136353634633266346463343063366134396430653963383464333932306366616635343830
63653933343131353437336665353239623438316138626432636230663539336134663835646564
37386364336133373233643034646330393161346531343837396232623765373031376166643739
61396137383237363031386663356232376133343964313035313536343433616332663164653436
37656531313130616435376231373362396630363564633762353265356639623938386166363732
64623132636234643537326364356136316334623762313630656634393033323737633036643263
30383864663730646632373662396231326466373265336533333935383237323430313536623236
61326662333236323530626637636264396433613832326239333932633435366165303266616131
31646530393763306631393364336531386637373439366438613037313664326463383865353061
33383862316133333134343231616230343138616435626563363865316661303961653732366634
30646231363034373938386638363838373162633266363936383232663735356336396439333763
36346532373431373032396361656237343264393839383763333830646536313565343939613865
61626139623563383530633731333934636462663730623564646133666638653038616432313437
62616139353033643564643733356562343336386138623031623938343135356465656231653230
38663563656636616636383564373138316236333365323839666133313836303331643830303464
66346139383732383038333461316130663839376462303164343961616638316566393836326165
36613630306364646565666635356230663038333564353039653032666337316264653262316631
33326266623664396465363461643966663961663038343365333736323864333338316665346435
33303764356233653464333832636134623737663034643932383166363731616163613034306539
32643863623233663334353466343131303566373238363338666130333236303231333664353465
31353637633163386361353861633433386164363961623234323833663032386237363031376431
65653433623235326636313533306634346339663465363737653338643364653230643766313962
62386530326365356461366432663665623432373663303134393237646263633831393331356634
66313532366137666632
