$ANSIBLE_VAULT;1.1;AES256
32346265396463643234306666353937343335633530616164336332343238366239376566626133
3939653761303966366661626363363934323337393763620a393031656461363438343733306431
39653630636266356165353634303738333561626439316166373835636238623536656331396338
3665383830623432320a653237636262663564303638383664313135633630623937303761636362
39653432646234326332303136616130383766303265633631376534363362663064646437353839
37626230616332316661393135356334353835396137623464356333303563666532303136373736
65623166663033326164306130666236363334653931396562663131633065656462373837306134
35346162653036616163373163393733653364616530313936313339396163623030366632313663
63386134623134656133383366666532636662343034333933376264366230636431383631373433
66613633363865373235363431646232333634376462346134326432353733343535613235313235
64623937323065633834323064376131643965663330343861623331373962653834393230663135
31373833396339303761323533373937306263323463656635366237373835373031393163616464
39383134333936666264656637633632333935336634666263316266353638366337616437646338
61326661343066663334663133623262353934653934303565626138396263306261653933363536
39636162666466356634343065643461396131643238663639346131333765366563383264643165
38666130633933633335306339383663656432326165336331333262313339393065333135316334
64386631353463383738343539396236333936633030643338383331623834383730613266653731
33656437353761326532633439616465313933636465343864326535386538353266343764346632
34316335626531313865313032316538613934353962353337373333333330626665316538653866
32343937386164343835323363323934316239626438616361323633343631356664626230393639
39333035616533376339346133663636616439303638353139333138666265346631366364663032
32613964303862653762373264346538663466383830656234376138656663303135343039623161
37306635613862336164356361373362386361306664383932373064343264383665656437653663
31633036383731313563663666303565643333623261633163613136343932626365626337356239
64386333633030633331313961613937343539323866313830333666636637376633616432326332
62323131363434343035373539653333323734376263333761646266333466623934643863353463
63653665323733333136363565613766313863323361613535363832343762373862343738636361
32313831366431396663663361396631326132343063633834313961343033626666323632613833
64643337646563386461663365633136366133636361656532656230333639306362303661353834
39653462316662316633373030363061303932376431303836353966613666646264333962373531
64336635303566323339326532633263393564366431663936653435326230623761313231316532
31373164373132303864646631643863313463373766636461653330663765663238623066383166
39636632643564663738383163636533663864663464626134393939316230653136336530326566
61386561313039383738323464396232623761323034663139303864326238643063386130666238
37633537373833373435363364613337333561623065333364326430346633613330623331316264
65306239613336333537393437373631653464623862323938333935306630373464386162626464
62343461633934393564373664353933653366396231633731333239653838336139663233336236
31613434653737663039306436363332323035336562643035643433316131303838646537663933
64623934346137393036656132626630326463303764326332646435633762383565643037373139
39383666356362613038646261613465366366666638306332303431653633336166353339306161
66376233343763376339643264363261313732363436366262613930626236613462393163393861
62356531306163393837353462313664666639343561393633656633636164626536343433373631
37626533316138366532346262376362316438643062396235313435366433326566313936363963
66396531383066336430636264616538393661633763376338303737396530643963663536613530
61373538316634393862613533353162326662366437393565383336376436356331666336316633
65376362333166656534633266643562373531336665316338643864313838383639313433353462
32653733306535333261643336336631666135636236623835376235636333333361363063336537
38393565613861326461613238333365396637646331623932303464303330613465326630343930
39336465633063353031396535613631663935643265323863633566393136373237643362303564
63396635616436636361653630643932353365346130373136383133323361646338636534633839
65336134373764363836383835393061353130343338616439326437653366303564373932653063
62393630333631393366363064386161386163353331656264303665643336643566623339333964
30623035653131633038313231336334336238343936336464383134633765343061636136313435
64353764396562323663623762303465376664383639386630633738373932306235323930646466
32383962636537393336636137323739313266663039356636363536356566626665626139366138
35633662623534396365333166656164653166616463316464386365386461343763333731613063
61623530633862626433363933373034336465633666333636313466323236633738306662316666
66323565636361363337306661616466643437313565386632326565393266333433646139363232
39613330666435376231306536333562336333386332616130323835386530326235363663353961
63323437366237303762646437373731343037303934663030643063333136646161373036353431
63316365393132636134346635383231643736373164666564653566383231373261663263316363
39363637626530323333653035656134363063313363613433396465666433383437386631393134
30623935626638373138346561353163326639396666363166623161646465346333313763356262
62313462336230613238383836353935376534643137323435373662646439303462616366663234
64366131396463383231336333666162616164356263663431616539343866623337306437346632
66396263326137643862316264356132653235363361613331353161353166626534643934356137
36353561343431636235656431633732643334666165366331306633643630663966323138656538
30373935333265646431623762363632323165636664633264353933383161353034313264613361
36376532376333396333393863323138626130653739653738313765386636323963616662646163
33663661633963356562323261363630633735393435386433363438636135636636376565386362
66333663633766623662336464613930393532633361636230633438666664353733303564626235
34666363396134383038646239363565336461303265356136366334303065366631656435393565
31303463383933663631373261383533393839326637343337393930633664366464633031323233
61376137383734383136633432376639336161336565313236393031623164346230366334326132
32323039396430636432363765393863303631326338313166336237653463373432333733323265
61363639353535376136653731303164383265333863343732646234656233396439636264353339
65303364343834316334366461323433653365343663393665343963633639636362336136343736
63353761396430383434393762383834306333633565373132616262396638653264323166393433
33646362626139373338353463616630326236353261316264393565376661333161336131613737
65373730613736386530643838623034343033373034333234303435383265366639326136363334
61353636313630363564363737623639356635323738383562373338303832373536353965363461
64383534643333316636353464396564353661353538653061653431623465393265663566333763
63396562653666643664356538383635376633373066383639326465646165323534373137393730
36616463303633343234643738383930353162303964666531316230643765633430663561626663
30393462666233663732373239313039613465333336386466306166626332336433613736386232
34623762363463643634343233306635353264383930666537626561383231646432616132336537
39616335336539636333633935643533326531323439303463356439326430653536626263303763
33323037626630643263643864333161353933613265323237656465363061333337383139333065
36363238383433623562306339306434323433353134663065626434343438346666643837643466
61623164323932653033383462326434393931666666363137393861376137306636633737653039
31366231363935663266666238656563656662656334616330666161666438313235613164353863
30316539313430336636663065333266346231373666313939666231643634396461343538636163
32363730363865353261346135376361396363306535313565653636613832323930346130363534
61333334373230656537373930373334393966303766663831636234663937306435306432306634
30343332343362393862616434343663336331613964343431336561376133656530303262643463
61343030646265313339356230653431376465626662653561643633323439333136353139386137
62316434666633316133336130616136323039396530393730373037633462653638313130313062
30653036613139353130363366356363626365643762336338643737336565653764666335363363
31376435626333393135633461633037643830343834653463646563396264333832323864663335
63666662663261373662383136656435613437366232643839346466343330346563356334633232
66656132313061626662333464313931383738353438376536616635353930323234653566343134
33333535663133636433386439653737636135363338613361656231633761333164623835313032
31383862623265313535643132666234656366633234306333376138313638663265373339303964
61346432616431636561353761336535656265616531333436623263626230343765326334653462
33383432323736383665313937666563323933393734373935356664613762653939663637343239
30626638393738643963363034643332653137393736313064643534376364343934633136383963
353934306239396332383737313338376530
