$ANSIBLE_VAULT;1.1;AES256
36616366333964636337656236306336373863656566653339616366643962613863613239393730
6266643332353162353631313965393031366132613238330a636662333263333933376166626331
61373732346438383665616536313934313730653530366663396561323364333162626566323365
3336316630656432360a323833646137393766353662353430666637366466646638373062346236
35353738656365636238373764356539366332326434626639636664626533623961396365336337
36643636633233363466353830326633323263623034336662653938303463393536663437346237
33366330303766663337653234353137366638653664376237666230633564326338393837313265
39396362336264623465353734666131326562393864333435396437346236343330646663646439
35653361323363363065393431623635373036383234313065663237356536633439303533323738
37376264333963336234653239393833336639316234623665663531326137393030316164303836
36663839313339383236363963323366386134363537663535646535356165356362613034616165
63373336326166643738373131333030363861343839396436366532323931353038366166616466
61613237646265306331326331343663613130666134373536313662613438616366633037613234
38636565346264323465373531623034633034396362356431653234663165613238313962353762
61376139303138646562656337616230306461356236376364653632353964666664383632346165
37363962306430383135633831323531366566383163393834613665316132343961323332303864
65613434326465313139316132656362646439383664323639356133663662386263353334653234
39613430363361626165616433353964636161643736306562366333343633376436356164663331
62376661316435613334633839376464353562383062373837326139303866356464383263633866
31653761636138636234313461666161353162386233663464366464313264626632313538353964
64616439356565613233636439613361333431626662343535393335326331636132313033383135
34393363363432396538313332376237343036643339616566373764313165353732633838303963
61613937306435656562363934666664366364306466336564366662353265316530663730613130
37313165356161356234353136386136373138623032366439313965363530396538316139656366
36666438623338353235306136306436613161656133313336376139656131613231653864613739
62366138613930613831326365666434323666653663663464386138346566646130643033333464
30353134663035346465353064396634343934663365333063633831663836383230303233653365
62356434383037313630643464323536373134363233376137353764303536396437653233623338
31626666656533623939373364396238663930303534663734646230316363646663313038643630
39346631346235353236393838636432303031353732646262313862613839663765653234663566
34643733346331653733353833353363653761663735623037323562646266653263343232666631
35336564386631383865653732663933646533613636663135343231363832363638303932303830
66366233643533613861666534313464626337316632633366333536323032623663376664656330
65623866663932333365303931653735373239633339373533653539613862373839383835663439
34353134363431373137616539393731313935373830373233663466346166346130306464653166
32663733396538613637393539306237623039626633366132646536333364353536336235643264
35353631323635303035366531626262343832643538313661623932623139656533
