$ANSIBLE_VAULT;1.1;AES256
33626637383839366637613866303434303062356432613239396238316639616233383238646137
6632343234643838613266636239353565663434643764610a636664636233326461366235303866
33393136656430353564623338633362323430666131303562313066356161306264643436613932
3535633034623537650a613561336236656433306461376539623735393732333963303439343336
61646661663137623061326639356536663636343339366432633438356166343066326438333166
62363339366661383533326432333863376438306165383865636466346266376336376361323638
30323330316661306663353531336666306465663232393336636235383866363639393433343836
66643138316135373636623934383861393665313864366632393462393837303938386565356265
38396436353635653632356164333866623030393663336361626565643832623764393438613030
35303466656634353634316335363832643530386539646539393931663563663862613633343134
62633862313633643262626337396634643763646362333635373935623435316235323634636634
65326564383031343037316339386439386463346466623331343832373333666336366265623135
38343533646535353937323066616161666466616635346433626533623234396361373032666262
66343736653164646233656537386564623335313935633062333436623735633434386161663565
34353866343365643732326266323661636631313064313833306632323463346162396463663763
39623930363933313966666239626239376336633565316430396561643334396530343636396233
36313564653738353438346563396236616662643464333338356534373362326334363261393865
36613636353434646562343862333961336134366161363765656365343335303061303263366532
38613666346463343231623030633931303035616539363262336165303237636430623564323964
34303938366531393135383737373534663731376162626532373561353534306430376362326337
38346337323534636264643134633535343764376233353737313634326231633337363162616432
38633030346263396364346535623438636563323439356531636139396565643936353366656362
34633733613433643335313033646333663639623865346138356636336539346164656630653166
66666164333733623430393837646532336564343036353966326566616139303361613730396436
64623632353961343764636337366666366135393736376231626266326431316432393463383337
33333036323431386564376361376361353363343037376430633166356438333361393637303364
31366239303534353330333935633839323832343738653331653964346237353432323236313636
33343637303838343166353066653761376436333636663238343239376533343733393761646438
63356632333733383266376163363461613865623435346534633736616631393537353435306636
39353031333963633433653837383435306136623439373333396136303739306163326133306432
39333038393731376666666130636137343736643035613666326531663261323538373463666135
63623335636166396565316131623162333433383162383165343265626165666633386664383532
37626664653339636634376362326464666632643563663236333535626665656564633533326234
36313230303162653437633236646661363166613835616333333737343366656663353464376536
65356263326637626331396565323232653536643237643963613032333933623334653466333761
63336435316634316261303433666164666130353730363661356564353066626235313163623539
39373637393163366439643837343832643934313866613465356632346362373066
