$ANSIBLE_VAULT;1.1;AES256
61646435636366333237636339663332346638373136316634363331633866376233373965313536
6434326466363637663137373661633061643261383831340a306133343334313436386563363032
66663737383836663536336261653434663238373732373661666130343465643734336438656435
3565366338343663350a663830613962366535393861393461653066366636666161666430656561
31363762613731623930626639396336653965373438616131613130396461316334663631616336
38373866313866636464613339613835626331646664313665383836643664663937623436623163
64333364613036336562366434386637393764386234396238636566366135323138303766633938
63353136313538353866633738363662346566303561393538663833313938333734376538363238
31626430383865316431623666316262353533633736396161386531663935323831613035363331
36353534356439386131613039626534373038306433353937663662316238396466356330336239
39386437353562313036383465656434613339316331316565306638373632383338336563356133
64613136313930376334383331313862623963363138323538313363326139643333336633346532
32326462326666626637643662356462343765373734653739353766323337663238613439366239
37333037343363663636376234303936363865626331383262613637366432316435383836303234
39373639333466383335623862323961346432376365366264636366613832383362633362303231
38366265303634633935653461323462396466346131623162313266643035396130303466353637
30383636303039303630313264356563663235656336303039313334623438616135623535666539
36363262303161343166366563626539356163323665333432653633663762666261316335653030
63663138653437326230383964373531383635393637336235343635656365383931663835346639
30373631633833363632313732353264373338363335653333306134383164383434383630626237
64316339646166623264306539646630613466373035666132626566623535303962663135316333
38366363643464323939653536313764303035323663306239373936373538386136303162353734
62663734346536656531323665356430366666633166343031616239626565393637363930353932
31313239663933303862343738346338623830616566336439326335383833373239623634623938
65386232613536383063396536633632383066353939326462373661633634393930363039633433
61326130616436356131326236306630316133393830376335643234653964663935383739313062
35636162356463343134626638666135623231323530663134633534356562613162333434646137
30636432313535633638346261623264613935613930306334366363666164323332663035343262
35323536326639653436313266613830346431343236386230393937633231333265613832326633
34393762343365376263336461396434303239613830313439313364376230353533343463353333
63613638386132376434623435396436366531303637616434643434623531306338373433323938
32383932623063633733633530646231643634626138316136643036373334393034613136363138
36353266373134363838323866383636393561626361306137323433313364366337363231303566
63363139623634353039326239373932663664646461653333326538336563363932373062393737
39396630626134386464353531643030343635653764613066393964663334616539356237363561
31656130623736393461396132323837313435656662306364356565386639396536343066613234
3239
