$ANSIBLE_VAULT;1.1;AES256
37306166326465646265663862373138376362313534653335653065656531626537396265633439
6231613331626664336232323064306630313530393637640a333561323539323639353363646239
31386439613637646266653535326664313661613766633838373035326664646433623066626466
6336396534386532320a613934323535346433366532626235353631393535313231643362376363
61636165666265396131613337323563376461363932343739356635313632386631616266663431
36326464613433353536323636643531343134336633306232653362386464323837663366383965
31346133306131356465313763306634353765303231646535333561666261386637356530356139
64343966323166633963393464626337396133343032333432663231626631623433636565343831
35386436383966303032356437653264613732323236323438376236623233633833663766363463
65383866333131666464613465383230623863343065633366666537356230646434633662653130
35666233333230653466336265383734356335346538323634306536636631613738306564373638
64326466353932316535333130626137656433376366383233313966666365346635313763306263
61623534376335366462326265653534356532336266373138623238393036646366326563386136
61353066623361616436316235303462333232663862643961646165613536656430633764623263
63636634333766313931356332306263363831613633373061323931633931626336303835653837
32333833303935396436633363363532313765613638303133643736373036316562363165396430
61366665656334376633626564393561613330316338316635333030653762313465336263616432
36333532356137386466326339346432376432336562653138636337626466336136656439653663
35633838653663613062613935663130356434383935663764396235396236336635356464303832
37666339643339656133356234313033303163636163316232323235303234646361363238353236
64646261656663663865633866323938306666323862633865623963616465343531383362333531
35633530623832323065666533306430663734623464316631346161613766353762376533633934
36653535613637363662656266663461356662633134623238353733383136346661396566376339
65346332376132366430323063366263306339616232313134643437633735356266396634323436
31356336386535633363353032323762626363366630363334633463396461373565623866356435
36366532633435363937613633613536613662613965323466336436316237356237663432646533
33326435313134346466373633306139643062353237373266333861356135323339376333646339
61396665636334316332653234653263336533313937613664343838396663313038393433333434
65343136353238303962393965653966323261663535656462396565636562656263366434626362
65316331396662396537653565396461336434356664656133333230383362333666333638663433
32663632306235656334383263356161373639326632636466646436393631366236653936363866
65373766633237613531643563326463323439623035336430643332623733353735386132383337
66346437366431666262356230303831323337323435363234343866336261613463666534636337
33626433623033613732336566386263303938383334336334346138363039333535303861383663
65626162643939356366643166343232643734663634313566326136323836343663636135363666
62343761383035396464663730373366336661373336663762646630323562326634346133646531
33636535346438303035663139393837646339613961353466346437633334376331323964366638
33303664306531626533346134323563356239623937626362353563373634316163376430383237
35353737363966656261633236316664323531666636656135613466623138363732396561356562
33313730646162373533313239393964616562643633353839636433366235666633633430346661
65643966356332326566326463346465313337333463393433613734643932353161343437316237
61666532653332363865336432353862376236663739336439366666386536373232326466393664
34373435396436646364303761383936623230646131353531626565626131666535656238663237
66653532636234616530636139623535383233303434653830373166393330393361663630376637
36363062353062313937613663656561663232666261373635666239643962656530383965343736
37363730323566633132313961386539616161363234613630353761646131366334646366616433
38333561636532313631393939373738343330323061666134323632636535613961613933613032
39656539646631663936353338303330613434623738663663333761336362633433663938643536
39326136353733346534653231346662386638366136633464323839393130316331323436643638
35343961366565363030613332353932333832653361343334383666616636306631623765616536
38393533636231316666333539396238636134343864633434353663363631623065613032653663
37633964313835613964643136656331313463333037333434643235323961626535666661393130
34336164303334343838326434306539303430653134373262386563613732336134393538366439
37333736353637633866363234363666393664316563356433353264316230346137393262653863
33323639343261303531393834383137646431633961353532393065396235323531633332613533
32303566346339346635366334366331363361373136616330633934623436396235383465336438
63373462373464633731666566356235643434393738336339666239363732656161336231333963
63313232373264326232303238643065343963343963316436343639363633663464626334306435
63343535373732373532613238316337633663366438633165313235323234313730623164326138
37666234643632333432656439633161633164373839383232623639303831366335633464343035
36613838623834366563376234646538646461386365396331346332373231613432313939633634
32323133303565393338616539306433643930313735306634343332333435633930353630643563
66393031393762666631356633396365616431643231303538333037336363393538663166396535
63313034643831663237323231393831646335623531323665346664333364663065643861646639
65333462396135333134353837616139303265316662633035386631363932313437353061316662
37636637633165363632313139656531646637653064616564303633633061353261363732326132
62653635643539346136643737393665376533396336303034653463656536343635396538373336
34333933666664653564326236653538313263366566333537623032333164313836316335303261
33373330376136303134393261656464393666373132306532386633646431393965333263313836
30373537643236616532363130323837373961646363333963656464643933623831653163626231
36623134653863623333393030393039323333363461336331303139396262323630333665353639
34376138306530363337353662663061333834306539383664363630376636623636316564663138
35316537386666376334633337356439363063356333356333643939373763363465346462313962
61613537653139396163353634306334623766633834643030666665616666613966386130646334
34613434313432356163353436633866633130633563383364323438666161623738346539653834
62396339653435303164623338623363633963396264386261633365643561613531333466333637
33616335373730396138393435663634623563653966363964636138623066616261356532353961
66636137323266316431653134313134343162653231393565313934623436316230323931663965
31313539396136386333353632643133343965313139346435383265353663626162393136313134
66303838383663303161323331303633616534346631653535303633383930386338656235356638
37353032623237376362363535343565316662616535353430316539633863383036616365343935
64363837326530643635666337656437396336306335306533386362326264623263396562643536
34393332653836346265396161383231663163633237666163646465353465333439636534666530
66626534616338653134316363356165383635373261373663306162346435333334613738636664
34376636303538613164316566666432626636623231353161323365376163373866336238383132
32316231653132396331633365663963663863386265383862623462326432326462633638336238
38386334623638313564643130336536326666323039373563333363363631636166303462356362
61363133326162306664363461383736666335613365616664383534386336383065626634386533
39373464306166393436326664376135323836653130343565313964633663396634636261636261
35306137303264393161656266333032376334613230383130356639326532643462646162646330
66396137646338663032343930336336396538323565613236373064323239363462356365336165
62653762643165333136303437646363393634656166303563653463323365656162643235656663
39626664373063333966343335373962643563336431343833663365356234623137373634323638
33383734653632366430366632363364313737356631396438383237656133633036616133323934
61343336643763363632333366396131373230643937613737346330386436633430663664366565
61663933346537633566373962393335663231383438386631326163303335353431303039393638
64633163353430396266343963613432356163326336343936343930623566636334343165393934
31303839613531386465356534663837646436653665356437626565346361623436356239303030
32663261636538316134366232386535663236626163343961613961653735303262306464353837
39643364633333613966643334656435633766373866313261383161353162336466663565303561
37646537643630643233633935616263383163623739613363366563383666616264633466373666
38383534306639383039623438613163643731383761616164623633396361393232323433373537
35386232333035353138363162643934666163326232363838666438366366376362376464666131
35373837396635313663383935303834626561633330356139626134646264636266363738623731
61613231303937646566396339326131623139656265386235353464313065636265636265663434
39336435346536326566353033373434636464646638313636373135363665346164616434373431
34373838396430336438623531333331323764616662396164663033656239346637316266616564
32373736353334646238383335383835346362333138396563623235393765356436386636303662
6433
