$ANSIBLE_VAULT;1.1;AES256
62383033363463313964346666303737643536346331346432636332643566313263623663326633
6534616337626132633232323432313966363166316165390a626664623165656264323235323036
34666363316130333363643565353238613964613633646633636664633466336332333036623936
3230336134343562640a306636623631376131373930643037363166343031313237663432316237
34633864323331633730326231636163646166333432353039363838613064653162643438613535
64626333656335343131653938383837666339306436323737363333616463653434333536366363
38383635353831653763366138613535343930333462303762373239343165313764616137656266
30616462663039353436383238623436643137393531316631626530363365336531643435383864
31356434636539633833646465356539656333333534373637323462393831643562386562346337
65336132663165306338353439643937316235346662623936353334393337393861316531316537
39623665663761366338343361323532363864363265643830623565383665616130633361333030
30616566623665303964363564613735663138356538666335363665373431383730643733633537
30333466636533396465356137363133313134333537383231363534383264613066316561373365
30653337393436613038643937393064313462333564383231383061616132666165396634643831
32316437316563313730643063353462313662633533346337356431353065366565393863313964
65663335666134616337633338623934643138663265633634363366373066353436373530383935
39623235323431393332373231663430396237333232616235386231343561363635333735653539
6630623332653334356161363533303332643435653363393066
