$ANSIBLE_VAULT;1.1;AES256
32343734326164653737303935323730373839666231663130613034333036396439363432346631
6661376132356465383361363566656163376662653836390a656163623161313231313830323961
33373534393462666135313131663031343564363134393730636131666563396530623231636666
3861643564666235630a306239333630663666343735646462626435313261393764613034653433
30633765626239666631336433386562623337646331666332613632626462323132363465313931
31633935383737653865303937373664626561303363623139663831366535393162356162643035
38633461343035363161343339646466393736653236666333373165613933623263656333323466
35363965313138666234356161343531336635353734353764326334343537323735666137663635
34613064306264326566666331393963383230393761626532383664373332626362336161303135
32356362316631363666306165373362343234313231633162353837316537323762636333333563
37613435373239353638383434383834323062393039626430393036656133633933613537343964
30636539336461336431393233393061393464643131643264336562326165396538373735666132
65323133636664343361363666616331303135663635363165373863326463376333383131613730
63633862333866646134383132313538613365313931313862356162326266623034643361373331
30613434306238613466366363343537393134326639336462353733643634313066303266333731
34343230373239666135656134663166636533306539373535336639303330396236643634616264
38613164383765653132333230323962643061336463333561636135333035636131383963316165
38376365633961376663373765383666303030363936613234343966316435323663313637663564
63623439323834343938623836666164383033303365643832353937666538313633623265643438
64616232373434356230623762626437336664336232663763623064323462313137333938303738
63393036646665313634653735386235343636636438646539323230613166376366393161383138
62363461386661373232346136663735643332393139636364303137373166626138393730373532
30663837663139633437653236346539666563393132326162613462346330353137363561376337
62633530663939353262653263343139643364336634323730336632363132363831636432346161
32653533333233316438633462653239616265623236366364356337366563656139663734353733
65353830343734653736373766613433393535643733666564353738323932393561613437343061
33313266386332646132653662343862333066646433373463643537633161336262613030363533
36346139666138663139316365636535653730653530366563626537316465383761326534363566
32326262333866633432326435613837396437396335326136376235323062393831306434366361
62323234343463303263366632323162333865396565376536643265303334323539323139633661
39303162383466306662623234386231376132643231353236613130663538663662633632323133
38646466343765633933613638623438626263316437376136396562383763613635333632313037
35313230313438393363663936613231373232313430333362653636383530323239633439303462
39373131316237363132383865353337373830326432326238663566343535346130333934626433
32333938393065313965313532623766326238336564613831636335343230333337356466636230
66346130646262626563323735376235336631653961653036353336333137303036336331343636
64393037626537646637643339373061666430326666343634376337313736653636666336343161
30373930346636613962343037363965666434633832316531323136636434616538616631343863
31613766363062353964386636376233333737353037303765366238333261643862376637373866
33353636333935376432326161613364313331663663376634313334306433626366326330613838
38653739326563656336326436613266343064623234363363383830623538393738616335666131
36333933633135633937633437663330323963623931353032376636356432366266646562393939
64653436313338626132373031633865393437666263666338366436643436616330313330303331
62366538396332353934633464653937643039633533633233383639333133626532363764386234
36373038626237366135303834393864653135666636633561393539636162633636616563373236
31613962343763623831393832666665343035626262623535363032646539363439396566343033
63353266616239326466396437646637313630306339313931646665303832613439386264626632
30363334336433383339663563333964613237326630636331323165313266303636366633356561
35363663336461363761303431343364633539393234376366303364633434393832366134326336
62653339306237343830313861326339383862633333626463653434663636353937626130393539
61356361333866613238343164313634343534646462643533656562633361396237623736393934
36623562646539376535323336366464353239383132313130623264383366646436663335643931
38616434616334336637306161636138393835343832616337376137323231393135303135303331
65323361343237303933306233636132643965393561313133366265313961346535386234646430
30393036333433323734356262356163353439643866636661323462643030353662306662626632
30303965343061643236646463373232303437383738633664376133363664613262623038323264
38663062303561346166626430663332633532363035653763636335656237353561653631303937
62363737336635393133366436383766333464663166663832303233306330303237623830363734
66353939323032336631336135383731626536663761306263396235346536653639353033636332
30373934323966346162623362666166353433343137383339366362636538633261393733346363
65646165383130383566636434346434626531646665616665313133653962393235303538346136
38333331363462373866616235643163366333353136356466396332613439316164386462653064
30636637313035363139306237383364333237396437333837316534666531326235363630623035
63613666653531623661323761393565326530643030363262383365363366313938373064616631
31656665373437646665343565643364623736373666393063353730653964333064386531393235
33656665333164316537326339383063653133653035633430366265613639613835316637313033
37366531636231626433383334363734393362373933386365643333383664383536616663643962
36303832346439353637363738356339396362396231643465333634396537363633376566653832
39653439643232306165623938303563393334393330373036643232336265366138613262333364
3963393431616364386565323138366334656537353365306365
